##########
XXXXXXXXX#
########X#
########X#
########X#
#XXXXXXXX#
#X########
#X########
#XXXXXXXXX
##########
