####T#####
BXXXXXXXX#
########X#
########X#
####T###X#
#XXXXXXXX#
#X########
#X########
#XXXXXXXXE
##########
